###.#######
#...#.....#
#.##..###.#
#.#..#....#
#.#.#..####
#...#.#...#
####..#.#.#
#....#..#.#
#.###..##.#
#.....#...#
###########